E N N N E N N E E X
E N N N E N N E E X
X E E N E N E N E X
X E N N E N N N N X
X X X X X X X X X X